11111111111111111
10010000000C11111
10000111110011111
1P0011E0000011111
11111111111111111
