11111111111111111
10010000000C11111
10000111110011111
1P00111E000011111
11111111111111111
