111111111111111111111111111111111111
1C000000000CC000000000000000000000C1
100000000001100000000000000000000001
100000000000000000000000000000000001
1001111011011001111110000C1111000001
100011101101100000001101100111000001
100001101101101111P01100110011000001
100001101101101100011100011011000001
100000111111000111111000001110000001
100000000000000000000000000000000001
1000111101111000111110001111C0110001
100110011100110110001101110000110001
100110000000110C00001100111000110001
10011011C000110000001101110000110001
100011100001100000001100011111100001
100000000000000000000000000000000001
100000000000111111111110000000000001
100000000000011111111100000000000001
100000000000001111111000000000000001
10000000000000011E110000000000000001
100000000000000000000000000000000001
100000000000000111110000000000000001
111111111111111111111111111111111111
